{
  "Name": "Tutorial",
  "Player": { "X": 16, "Y": 25 },
  "Walls": [
    { "X": 19, "Y": 17 },
    { "X": 19, "Y": 16 },
    { "X": 19, "Y": 15 },
    { "X": 18, "Y": 15 },
    { "X": 18, "Y": 17 },
    { "X": 17, "Y": 16 },
    { "X": 13, "Y": 15 },
    { "X": 13, "Y": 16 },
    { "X": 13, "Y": 17 },
    { "X": 14, "Y": 17 },
    { "X": 15, "Y": 16 },
    { "X": 14, "Y": 15 },
    { "X": 15, "Y": 11 },
    { "X": 14, "Y": 11 },
    { "X": 15, "Y": 12 },
    { "X": 14, "Y": 12 },
    { "X": 14, "Y": 13 },
    { "X": 18, "Y": 13 },
    { "X": 17, "Y": 12 },
    { "X": 18, "Y": 12 },
    { "X": 17, "Y": 11 },
    { "X": 18, "Y": 11 },
    { "X": 18, "Y": 24 },
    { "X": 18, "Y": 23 },
    { "X": 18, "Y": 22 },
    { "X": 17, "Y": 21 },
    { "X": 18, "Y": 20 },
    { "X": 18, "Y": 19 },
    { "X": 19, "Y": 19 },
    { "X": 20, "Y": 19 },
    { "X": 21, "Y": 18 },
    { "X": 21, "Y": 17 },
    { "X": 21, "Y": 16 },
    { "X": 21, "Y": 15 },
    { "X": 21, "Y": 14 },
    { "X": 20, "Y": 13 },
    { "X": 20, "Y": 12 },
    { "X": 20, "Y": 11 },
    { "X": 20, "Y": 10 },
    { "X": 19, "Y": 9 },
    { "X": 18, "Y": 9 },
    { "X": 18, "Y": 8 },
    { "X": 17, "Y": 7 },
    { "X": 16, "Y": 7 },
    { "X": 15, "Y": 7 },
    { "X": 14, "Y": 8 },
    { "X": 14, "Y": 9 },
    { "X": 13, "Y": 9 },
    { "X": 12, "Y": 10 },
    { "X": 12, "Y": 11 },
    { "X": 12, "Y": 12 },
    { "X": 12, "Y": 13 },
    { "X": 11, "Y": 14 },
    { "X": 11, "Y": 15 },
    { "X": 11, "Y": 16 },
    { "X": 11, "Y": 17 },
    { "X": 11, "Y": 18 },
    { "X": 12, "Y": 19 },
    { "X": 13, "Y": 19 },
    { "X": 14, "Y": 19 },
    { "X": 14, "Y": 20 },
    { "X": 15, "Y": 21 },
    { "X": 14, "Y": 22 },
    { "X": 14, "Y": 23 },
    { "X": 16, "Y": 23 },
    { "X": 14, "Y": 24 },
    { "X": 15, "Y": 25 },
    { "X": 17, "Y": 25 },
    { "X": 15, "Y": 26 },
    { "X": 17, "Y": 26 },
    { "X": 16, "Y": 27 }
  ],
  "Apples": [
    { "X": 16, "Y": 21, "Type": "Red" },
    { "X": 16, "Y": 17, "Type": "Yellow" },
    { "X": 16, "Y": 13, "Type": "Green" }
  ],
  "Doors": [
    { "X": 16, "Y": 16 },
    { "X": 16, "Y": 12 }
  ],
  "Fountains": [],
  "Keys": [
    { "X": 16, "Y": 8, "Type": "Bronze" }
  ],
  "Enemies" : [
    { "X": 16, "Y": 14, "Type": "BlackSpider" }
  ]
}