Warmup 9 9
= = = = = = = = =
= [ o . o . o } =
= o . . o . . o =
= . . o . o . . =
= . . . s . . . =
= . . o . o . . =
= o . . . . . o =
= { o . . . o ] =
= = = = = = = = =